{
  "bracket": {
    "fixed_slots": [
      ["R32_1", "A1", "3X1"],
      ["R32_2", "B2", "C2"],
      ["R32_3", "D1", "3X2"],
      ["R32_4", "E2", "F2"],
      ["R32_5", "G1", "3X3"],
      ["R32_6", "H2", "I2"],
      ["R32_7", "J1", "3X4"],
      ["R32_8", "K2", "L2"],
      ["R32_9", "B1", "3X5"],
      ["R32_10", "A2", "D2"],
      ["R32_11", "F1", "3X6"],
      ["R32_12", "E1", "H1"],
      ["R32_13", "I1", "3X7"],
      ["R32_14", "G2", "J2"],
      ["R32_15", "L1", "3X8"],
      ["R32_16", "K1", "C1"]
    ],
    "third_place_assignments": {
      "A-B-C-D-E-F-G-H": {
        "3X1": "3A",
        "3X2": "3B",
        "3X3": "3C",
        "3X4": "3D",
        "3X5": "3E",
        "3X6": "3F",
        "3X7": "3G",
        "3X8": "3H"
      },
      "A-B-C-D-E-F-G-I": {
        "3X1": "3A",
        "3X2": "3B",
        "3X3": "3C",
        "3X4": "3D",
        "3X5": "3E",
        "3X6": "3F",
        "3X7": "3G",
        "3X8": "3I"
      },
      "A-B-C-D-E-F-G-J": {
        "3X1": "3A",
        "3X2": "3B",
        "3X3": "3C",
        "3X4": "3D",
        "3X5": "3E",
        "3X6": "3F",
        "3X7": "3G",
        "3X8": "3J"
      },
      "A-B-C-D-E-F-G-K": {
        "3X1": "3A",
        "3X2": "3B",
        "3X3": "3C",
        "3X4": "3D",
        "3X5": "3E",
        "3X6": "3F",
        "3X7": "3G",
        "3X8": "3K"
      },
      "A-B-C-D-E-F-G-L": {
        "3X1": "3A",
        "3X2": "3B",
        "3X3": "3C",
        "3X4": "3D",
        "3X5": "3E",
        "3X6": "3F",
        "3X7": "3G",
        "3X8": "3L"
      },
      "A-B-C-D-E-F-H-I": {
        "3X1": "3A",
        "3X2": "3B",
        "3X3": "3C",
        "3X4": "3D",
        "3X5": "3E",
        "3X6": "3F",
        "3X7": "3H",
        "3X8": "3I"
      },
      "A-B-C-D-E-F-H-J": {
        "3X1": "3A",
        "3X2": "3B",
        "3X3": "3C",
        "3X4": "3D",
        "3X5": "3E",
        "3X6": "3F",
        "3X7": "3H",
        "3X8": "3J"
      },
      "A-B-C-D-E-F-H-K": {
        "3X1": "3A",
        "3X2": "3B",
        "3X3": "3C",
        "3X4": "3D",
        "3X5": "3E",
        "3X6": "3F",
        "3X7": "3H",
        "3X8": "3K"
      },
      "A-B-C-D-E-F-H-L": {
        "3X1": "3A",
        "3X2": "3B",
        "3X3": "3C",
        "3X4": "3D",
        "3X5": "3E",
        "3X6": "3F",
        "3X7": "3H",
        "3X8": "3L"
      },
      "A-B-C-D-E-F-I-J": {
        "3X1": "3A",
        "3X2": "3B",
        "3X3": "3C",
        "3X4": "3D",
        "3X5": "3E",
        "3X6": "3F",
        "3X7": "3I",
        "3X8": "3J"
      },
      "A-B-C-D-E-F-I-K": {
        "3X1": "3A",
        "3X2": "3B",
        "3X3": "3C",
        "3X4": "3D",
        "3X5": "3E",
        "3X6": "3F",
        "3X7": "3I",
        "3X8": "3K"
      },
      "A-B-C-D-E-F-I-L": {
        "3X1": "3A",
        "3X2": "3B",
        "3X3": "3C",
        "3X4": "3D",
        "3X5": "3E",
        "3X6": "3F",
        "3X7": "3I",
        "3X8": "3L"
      },
      "A-B-C-D-E-F-J-K": {
        "3X1": "3A",
        "3X2": "3B",
        "3X3": "3C",
        "3X4": "3D",
        "3X5": "3E",
        "3X6": "3F",
        "3X7": "3J",
        "3X8": "3K"
      },
      "A-B-C-D-E-F-J-L": {
        "3X1": "3A",
        "3X2": "3B",
        "3X3": "3C",
        "3X4": "3D",
        "3X5": "3E",
        "3X6": "3F",
        "3X7": "3J",
        "3X8": "3L"
      },
      "A-B-C-D-E-F-K-L": {
        "3X1": "3A",
        "3X2": "3B",
        "3X3": "3C",
        "3X4": "3D",
        "3X5": "3E",
        "3X6": "3F",
        "3X7": "3K",
        "3X8": "3L"
      },
      "A-B-E-F-G-H-I-L": {
        "3X1": "3A",
        "3X2": "3B",
        "3X3": "3E",
        "3X4": "3F",
        "3X5": "3G",
        "3X6": "3H",
        "3X7": "3I",
        "3X8": "3L"
      },
      "A-D-E-F-H-J-K-L": {
        "3X1": "3A",
        "3X2": "3D",
        "3X3": "3E",
        "3X4": "3F",
        "3X5": "3H",
        "3X6": "3J",
        "3X7": "3K",
        "3X8": "3L"
    },
      "C-D-E-F-G-H-K-L": {
        "3X1": "3C",
        "3X2": "3D",
        "3X3": "3E",
        "3X4": "3F",
        "3X5": "3G",
        "3X6": "3H",
        "3X7": "3K",
        "3X8": "3L"
    },
    "B-C-D-E-G-J-K-L": {
        "3X1": "3B",
        "3X2": "3C",
        "3X3": "3D",
        "3X4": "3E",
        "3X5": "3G",
        "3X6": "3J",
        "3X7": "3K",
        "3X8": "3L"
    },
      "B-C-D-E-H-I-J-K": {
        "3X1": "3B",
        "3X2": "3C",
        "3X3": "3D",
        "3X4": "3E",
        "3X5": "3H",
        "3X6": "3I",
        "3X7": "3J",
        "3X8": "3K"
      }
    }
  }
}



